M0 M0 M0 M0 M0 M0 M0 M0 M0 M0 M0 M0 M0 M0 M0 M0 M0 M0 M0 M0 M0 M0 M0 M0 M0 M0 M0 M0 M0 M0 M0 M0 M0 M0 M0 M0 M0 M0 M0 M0 M0 M0 M0 M0 M0 M0 M0 M0 M0 M0 M0 M0 M0 M0 M0 M0 M0 M0 M0 M0 
M0 .0 .0 .0 .0 .0 .0 .0 M0 .0 .0 .0 .0 .0 .0 .0 .0 .0 .0 M0 .0 .0 .0 .0 .0 .0 .0 .0 M0 .0 .0 .0 .0 .0 .0 .0 .0 .0 .0 D0 .0 .0 .0 M0 .0 .0 .0 .0 .0 D0 .0 .0 .0 M0 .0 .0 .0 .0 .0 M0 
M0 .0 .0 .0 .0 .0 .0 .0 .0 M0 .0 .0 .0 .0 .0 .0 .0 .0 .0 M0 .0 .0 .0 .0 .0 .0 .0 .0 .0 M0 .0 .0 .0 .0 .0 .0 .0 .0 .0 M0 .0 .0 .0 M0 .0 .0 .0 .0 .0 M0 .0 .0 .0 M0 M0 .0 .0 .0 .0 M0 
M0 .0 .0 .0 .0 .0 .0 .0 M0 .0 .0 .0 .0 .0 .0 .0 .0 .0 .0 M0 .0 .0 .0 .0 .0 .0 .0 .0 M0 .0 .0 .0 .0 .0 .0 .0 .0 .0 .0 M0 M0 M0 M0 .0 .0 .0 .0 .0 .0 M0 .0 .0 .0 M0 .0 .0 .0 .0 .0 M0 
M0 .0 .0 .0 .0 .0 .0 .0 M0 .0 .0 .0 .0 M2 M2 .0 .0 .0 .0 .0 .0 .0 .0 .0 .0 .0 .0 .0 M0 .0 .0 .0 .0 .0 .0 .0 .0 .0 .0 .0 .0 .0 .0 .0 .0 .0 .0 .0 .0 .0 M0 M0 M0 .0 .0 .0 .0 .0 .0 M0 
M0 .0 .0 .0 .0 .0 .0 M0 .0 .0 .0 .0 M2 M2 M2 M2 .0 .0 .0 .0 M0 .0 .0 .0 .0 .0 .0 M0 .0 .0 .0 .0 .0 .0 .0 .0 .0 .0 .0 .0 .0 .0 .0 .0 .0 .0 .0 .0 .0 .0 .0 M0 .0 .0 .0 .0 .0 .0 .0 M0 
M0 M0 .0 .0 .0 .0 M0 .0 .0 .0 .0 M2 M2 M2 M2 M2 M2 .0 .0 .0 .0 M0 .0 .0 .0 .0 M0 .0 .0 .0 .0 .0 .0 .0 .0 .0 .0 .0 .0 .0 .0 .0 .0 M2 M2 M2 .0 .0 .0 .0 .0 .0 .0 .0 .0 .0 .0 .0 .0 M0 
M0 M0 .0 .0 .0 .0 M0 .0 .0 .0 .0 M2 M2 M2 M2 M2 M2 .0 .0 .0 .0 M0 .0 .0 .0 .0 M0 .0 .0 .0 .0 .0 .0 .0 .0 .0 .0 .0 .0 .0 .0 .0 M2 M2 M2 M2 M2 .0 .0 .0 .0 .0 .0 .0 .0 .0 .0 .0 .0 M0 
M0 M0 .0 .0 .0 .0 M0 .0 .0 .0 .0 M2 M2 M2 M2 M2 M2 .0 .0 .0 .0 M0 .0 .0 .0 .0 M0 .0 .0 .0 .0 .0 .0 .0 .0 .0 .0 .0 .0 .0 .0 M2 M2 M2 M2 M2 M2 .0 .0 .0 .0 .0 .0 .0 .0 .0 .0 .0 .0 M0 
M0 .0 .0 .0 .0 .0 .0 M0 .0 .0 .0 .0 M2 M2 M2 M2 .0 .0 .0 .0 M0 .0 .0 .0 .0 .0 .0 M0 .0 .0 .0 .0 .0 .0 .0 .0 .0 .0 .0 .0 .0 .0 M2 M2 M2 M2 .0 .0 .0 .0 .0 .0 .0 .0 .0 .0 .0 .0 .0 M0 
M0 .0 .0 .0 .0 .0 .0 .0 M0 .0 .0 .0 .0 M2 M2 .0 .0 .0 .0 .0 .0 .0 .0 .0 .0 .0 .0 .0 M0 .0 .0 .0 .0 .0 .0 M0 M0 M0 .0 .0 .0 .0 .0 M2 M2 .0 .0 .0 .0 .0 M0 M0 M0 .0 .0 .0 .0 .0 .0 M0 
M0 .0 .0 .0 .0 .0 .0 .0 M0 .0 .0 .0 .0 .0 .0 .0 .0 .0 .0 M0 .0 .0 .0 .0 .0 .0 .0 .0 M0 .0 .0 .0 .0 .0 M0 .0 .0 .0 M0 .0 .0 .0 .0 .0 .0 .0 .0 .0 .0 M0 .0 .0 .0 M0 .0 .0 .0 .0 .0 M0 
M0 .0 .0 .0 .0 .0 .0 .0 M0 M0 .0 .0 .0 .0 .0 .0 .0 .0 .0 M0 .0 .0 .0 .0 .0 .0 .0 .0 M0 M0 .0 .0 .0 M0 .0 .0 .0 .0 .0 M0 .0 .0 .0 .0 .0 .0 .0 .0 .0 M0 .0 .0 .0 .0 M0 .0 .0 .0 M0 M0 
M0 .0 .0 .0 .0 .0 .0 .0 M0 .0 .0 .0 .0 .0 .0 .0 .0 .0 .0 M0 .0 .0 .0 .0 .0 .0 .0 .0 M0 .0 .0 .0 M0 M0 .0 .0 .0 .0 M0 .0 .0 .0 .0 .0 .0 .0 .0 .0 .0 M0 .0 .0 .0 .0 .0 M0 .0 .0 .0 M0 
M0 .0 .0 .0 .0 .0 M0 M0 .0 .0 .0 .0 .0 .0 .0 .0 .0 .0 .0 .0 .0 M0 M0 M0 M0 M0 M0 .0 .0 .0 .0 .0 M0 .0 .0 .0 .0 M0 M0 .0 .0 .0 .0 M2 M2 .0 .0 .0 .0 .0 M0 .0 .0 .0 .0 M0 .0 .0 .0 M0 
M0 M0 .0 M0 M0 .0 .0 .0 .0 .0 .0 .0 .0 .0 .0 .0 .0 .0 .0 .0 .0 .0 .0 .0 .0 .0 .0 .0 .0 .0 .0 .0 M0 .0 .0 .0 .0 M0 .0 .0 .0 .0 M2 M2 M2 M2 .0 .0 .0 .0 M0 M0 .0 .0 .0 M0 .0 .0 .0 M0 
M0 .0 .0 .0 .0 .0 .0 .0 .0 .0 .0 .0 .0 M0 M0 M0 .0 .0 .0 .0 .0 .0 .0 .0 .0 .0 .0 .0 .0 .0 .0 .0 M0 .0 .0 .0 M0 .0 .0 .0 .0 M2 M2 M2 M2 M2 M2 .0 .0 .0 .0 M0 .0 .0 .0 M0 .0 .0 .0 M0 
M0 .0 .0 .0 .0 .0 .0 .0 .0 .0 .0 .0 M0 .0 .0 M0 .0 .0 .0 .0 .0 .0 M2 M2 M2 M2 .0 .0 .0 .0 .0 .0 .0 .0 .0 .0 M0 .0 .0 .0 .0 M2 M2 M2 M2 M2 M2 .0 .0 .0 .0 M0 .0 .0 .0 .0 M0 .0 .0 M0 
M0 .0 .0 .0 .0 .0 .0 .0 .0 .0 .0 M0 .0 .0 .0 .0 M0 .0 .0 .0 .0 M2 M2 M2 M2 M2 M2 .0 .0 .0 .0 M0 .0 .0 .0 .0 M0 .0 .0 .0 .0 M2 M2 M2 M2 M2 M2 .0 .0 .0 .0 M0 .0 .0 .0 .0 M0 .0 .0 M0 
M0 .0 .0 .0 .0 .0 .0 .0 .0 .0 M0 .0 .0 .0 .0 .0 .0 M0 .0 .0 .0 .0 M2 M2 M2 M2 .0 .0 .0 .0 M0 .0 .0 .0 .0 .0 .0 M0 .0 .0 .0 .0 M2 M2 M2 M2 .0 .0 .0 .0 M0 .0 .0 .0 .0 .0 .0 M0 .0 M0 
M0 D0 M0 .0 .0 .0 .0 .0 .0 .0 .0 .0 .0 .0 .0 .0 .0 .0 M0 .0 .0 .0 .0 M2 M2 .0 .0 .0 .0 .0 .0 .0 .0 .0 .0 .0 .0 .0 M0 .0 .0 .0 .0 M2 M2 .0 .0 .0 .0 .0 .0 .0 .0 .0 .0 .0 .0 .0 M0 M0 
M0 .0 .0 M0 .0 .0 .0 .0 .0 M0 .0 .0 .0 .0 .0 .0 .0 .0 M0 .0 .0 .0 .0 .0 .0 .0 .0 .0 .0 M0 .0 .0 .0 .0 .0 .0 .0 .0 M0 .0 .0 .0 .0 .0 .0 .0 .0 .0 .0 M0 .0 .0 .0 .0 .0 .0 .0 .0 M0 M0 
M0 .0 .0 M0 .0 .0 .0 .0 .0 M0 .0 .0 .0 .0 .0 .0 .0 .0 M0 M0 .0 .0 .0 .0 .0 .0 .0 .0 .0 M0 .0 .0 .0 .0 .0 .0 .0 .0 M0 M0 .0 .0 .0 .0 .0 .0 .0 .0 .0 M0 .0 .0 .0 .0 .0 .0 .0 .0 .0 M0 
M0 M0 M0 .0 .0 .0 .0 .0 .0 M0 .0 .0 .0 .0 .0 .0 .0 .0 M0 .0 .0 .0 .0 .0 .0 .0 .0 .0 .0 M0 .0 .0 .0 .0 .0 .0 .0 .0 M0 .0 .0 .0 .0 .0 .0 .0 .0 .0 .0 M0 .0 .0 .0 .0 .0 .0 .0 .0 M0 M0 
M0 .0 .0 .0 .0 .0 .0 .0 .0 .0 M0 .0 .0 .0 .0 .0 M0 M0 .0 .0 .0 .0 .0 .0 .0 .0 .0 .0 .0 .0 .0 M0 M0 M0 M0 M0 M0 .0 .0 .0 .0 .0 .0 .0 .0 .0 .0 .0 .0 .0 .0 M0 .0 .0 .0 .0 .0 .0 M0 M0 
M0 .0 .0 .0 .0 .0 .0 .0 .0 .0 .0 M0 .0 M0 M0 .0 .0 .0 .0 .0 .0 .0 .0 .0 .0 .0 .0 .0 .0 .0 .0 .0 .0 .0 .0 .0 .0 .0 .0 .0 .0 .0 .0 .0 .0 .0 .0 .0 .0 .0 .0 .0 .0 M0 M0 .0 M0 M0 .0 M0 
M0 .0 .0 M2 M2 M2 .0 .0 .0 .0 .0 .0 .0 .0 .0 .0 .0 .0 .0 .0 .0 .0 .0 M0 M0 M0 .0 .0 .0 .0 .0 .0 .0 .0 .0 .0 .0 .0 .0 .0 .0 .0 .0 M0 M0 M0 .0 .0 .0 .0 .0 .0 .0 .0 .0 .0 .0 .0 .0 M0 
M0 .0 M2 M2 M2 M2 M2 .0 .0 .0 .0 .0 .0 .0 .0 .0 .0 .0 .0 .0 .0 .0 M0 .0 .0 M0 .0 .0 .0 .0 .0 .0 M2 M2 M2 M2 .0 .0 .0 .0 .0 .0 M0 .0 .0 M0 .0 .0 .0 .0 .0 .0 .0 .0 .0 .0 .0 .0 .0 M0 
M0 M2 M2 M2 M2 M2 M2 .0 .0 .0 .0 .0 .0 .0 .0 .0 .0 .0 .0 .0 .0 M0 .0 .0 .0 .0 M0 .0 .0 .0 .0 M2 M2 M2 M2 M2 M2 .0 .0 .0 .0 M0 .0 .2 .6 .1 M0 .0 .0 .0 .0 .0 .0 .0 .0 .0 .0 .0 .0 M0 
M0 .0 M2 M2 M2 M2 .0 .0 .0 .0 .0 .0 .0 .0 .0 .0 .0 .0 .0 .0 M0 .0 .0 .0 .0 .0 .0 M0 .0 .0 .0 .0 M2 M2 M2 M2 .0 .0 .0 .0 M0 .0 .0 .8 .9 .7 .0 M0 .0 .0 .0 .0 .0 .0 .0 .0 .0 .0 .0 M0 
M0 .0 .0 M2 M2 .0 .0 .0 .0 .0 D0 M0 M0 .0 .0 .0 .0 .0 .0 .0 .0 .0 .0 .0 .0 .0 .0 .0 M0 .0 .0 .0 .0 M2 M2 .0 .0 .0 .0 .0 .0 .0 .0 .8 .9 .7 .0 .0 M0 .0 .0 .0 .0 .0 .0 D0 M0 M0 .0 M0 
M0 .0 .0 .0 .0 .0 .0 .0 .0 M0 .0 .0 .0 M0 .0 .0 .0 .0 .0 M0 .0 .0 .0 .0 .0 .0 .0 .0 M0 .0 .0 .0 .0 .0 .0 .0 .0 .0 .0 M0 .0 .0 .0 .8 .9 .7 .0 .0 M0 .0 .0 .0 .0 .0 M0 .0 .0 .0 M0 M0 
M0 .0 .0 .0 .0 .0 .0 .0 .0 M0 .0 .0 .0 M0 M0 .0 .0 .0 M0 M0 .0 .0 .0 .0 .0 .0 .0 .0 M0 M0 .0 .0 .0 .0 .0 .0 .0 .0 .0 M0 .0 .0 .0 .4 .5 .3 .0 .0 .0 M0 .0 .0 .0 .0 M0 .0 .0 .0 M0 M0 
M0 .0 .0 .0 .0 .0 .0 .0 .0 M0 M0 M0 M0 M0 .0 .0 .0 .0 .0 M0 .0 .0 .0 .0 .0 .0 .0 .0 M0 .0 .0 .0 .0 .0 .0 .0 .0 .0 .0 M0 .0 .0 .0 .0 shop0 .0 .0 .0 M0 .0 .0 .0 .0 .0 .0 M0 M0 M0 M0 M0 
M0 .0 .0 .0 .0 .0 .0 .0 .0 .0 .0 .0 .0 .0 .0 .0 .0 .0 .0 .0 .0 M0 M0 M0 M0 M0 M0 .0 .0 .0 .0 .0 .0 .0 .0 .0 .0 .0 .0 .0 .0 .0 .0 .0 .0 .0 .0 .0 M0 .0 .0 .0 .0 .0 .0 .0 .0 .0 .0 M0 
M0 .0 .0 .0 .0 .0 .0 .0 .0 .0 .0 .0 .0 .0 .0 .0 .0 .0 .0 .0 .0 .0 .0 .0 .0 .0 .0 .0 .0 .0 .0 .0 .0 .0 .0 .0 .0 .0 .0 .0 M0 .0 .0 .0 .0 .0 .0 M0 .0 .0 .0 .0 .0 .0 .0 .0 .0 .0 .0 M0 
M0 .0 .0 D0 M0 M0 .0 .0 .0 .0 .0 .0 .0 .0 .0 .0 .0 .0 .0 .0 .0 .0 .0 .0 .0 .0 .0 .0 .0 .0 .0 .0 .0 .0 .0 .0 .0 .0 .0 .0 .0 M0 .0 .0 .0 .0 M0 .0 .0 .0 .0 .0 M2 M2 M2 M2 .0 .0 .0 M0 
M0 .0 M0 .0 .0 M0 .0 .0 .0 .0 .0 .0 .0 .0 .0 .0 .0 .0 .0 .0 .0 .0 M2 M2 M2 M2 .0 .0 .0 .0 .0 .0 .0 .0 .0 .0 .0 .0 .0 .0 .0 M0 .0 .0 .0 .0 M0 .0 .0 .0 .0 M2 M2 M2 M2 M2 M2 .0 .0 M0 
M0 M0 .0 .0 .0 .0 M0 .0 .0 .0 .0 .0 .0 .0 .0 .0 .0 .0 .0 .0 .0 M2 M2 M2 M2 M2 M2 .0 .0 .0 .0 .0 .0 .0 .0 .0 .0 .0 .0 .0 .0 M0 .0 .0 .0 .0 M0 .0 .0 .0 .0 M2 M2 M2 M2 M2 M2 .0 .0 M0 
M0 M0 M0 M0 M0 M0 M0 M0 M0 M0 M0 M0 M0 M0 M0 M0 M0 M0 M0 M0 M0 M0 M0 M0 M0 M0 M0 M0 M0 M0 M0 M0 M0 M0 M0 M0 M0 M0 M0 M0 M0 M0 M0 M0 M0 M0 M0 M0 M0 M0 M0 M0 M0 M0 M0 M0 M0 M0 M0 M0  